      ###
      #*#
  #####*#####
 ##         ##
##  # # # #  ##
#  ##     ##  #
# ##  # #  ## #
#     DPD     #
####  ###  ####
   #### ####