#####################
#                   #
#                   #
#    ###########    #
#   *D PD #*        #
#         #         #
#####################