########
#P   D*#
#      #
#   D *#
########