########
#P     #
#      #
#D    *#
########