###############
#             #
#*  D #P# D  *#
#             #
###############