     #####
     #   #
     #   #
######   #
#  ####D#####
#           #
# *## # ##* #
#           #
#####D####  #
   #   # ####
   # P #
   #   #
   #####